XXXXXXXXXXXXXXXXXXXXXXXXX
X                  XXXXXX
X XXX XXX XXXXXXX XXXXXXX
X XXX XXX XXXXXXX XXXXXXX
X XXX XXX XXXXXXX XXXXXXX
X XXX XXX XXXXXXX XXXXXXX
X XXX XXX XXXXXXX XXXXXXX
X XXX XXX XXXXXXX XXXXXXX
X XXX XXX XXXXXXX        
X XXX XXX XXXXXXX XXXXXXX
X XXX XXX XXXXXXX XXXXXXX
X XXX XXX XXXXXXX XXXXXXX
X XXX XXX XXXXXXX        
X XXX XXX XXXXXXX XXXXXXX
X XXX XXX XXXXXXX XXXXXXX
X XXX XXX XXXXXXX XXXXXXX
X XXX XXX XXXXXXX XXXXXXX
X XXX XXX XXXXXXX        
X XXX XXX XXXXXXXXXXXXXXX
X XXX                   G
X XXX XXXXXXXXXXXXXXXXXXX
X XXX XXXXXXXXXXXXXXXXXXX
X XXX XXXXXXXXXXXXXXXXXXX
X XXX XXXXXXXXXXXXXXXXXXX
X XXX XXXXXXXXXXXXXXXXXXX
X XXX XXXXXXXXXXXXXXXXXXX
X XXX                    
X XXX XXXXXXXXXXXXXXXXXXX
X XXX XXXXXXXXXXXXXXXXXXX
X XXX XXXXXXXXXXXXXXXXXXX
X XXX XXXXXXXXXXXXXXXXXXX
XSXXXXXXXXXXXXXXXXXXXXXXX