XXXXXXXXXXXXXXXX XXXXXXXX                                                     XXXXXXXXXXXXXXXXXXXXXXXXXXXXXXXXXXXXXXXXXXXXXXXXXXXXXXXXXXGXXXXX
XXXXXXXXXXXXXXXX XXXXXXXX XXXXXXXXXXXXXXXXXXXXXXXXXXXXXXXXXXXXX XXXX XXXXXXXXXXXXXXXXXXXXXXXXXXXXXXXXXXXXXXXXXXXXXXXXXXXXXXXXXXXXXXXXXXX XXXXX
XXXXXXXXXXXXXXXX XXXXXXXX XXXXXXXXXXXXXX XXXXXXXXXXXXXXXXXXX XX XXXX XXXXXXXXXXXXXXXXXXXXXXXXXXXXXXXXXX XXXXXXXXXXXXXXXXXXXXXXXXXXXXXXXX XXXXX
XXXXXXXXXXXXXXXX XXXXXXXX XXXXXXXXXXXXXX XXXXXXXXXXXXXXXXXXX XX XXXX XXXXXXX                                                           X XXXXX
XXXXXXXXXXXXXXXX XXXXX                   XXXXXXXXXX XXXXXXXX XX XXXX XXXXXXX XXXXXXXXXXXXXXXXXXXXXXXXXXXXXXXXXXXXXXXXXXXXXXXXXXXXXXXXXXX XXXXX
XXXXXXXXXXXXXXXX XXXXXXXXXXXXXXXXXXXXXXX XXXXXXXXXX XXXXXXXX XX XXXX XXXXXXX XXXXXXXXXXXX   X   XX     XXX      XXXXXXXXXXXXXXXXXXXX XXX XXXXX
XXXXXXXXXXXXXXXX XXXXXXXXXXXXXXXXXXXXX              XXXXXXXX XX XXXX XXXXXXX XXXXXXXXXXXX X   X    XX XXXX XXXX XXXXXXXXXXXXXXXXXXXX XXX XXXXX
XXXXXXXXXXXXXXXX XXXXXXXXXXXXXXXXXXXXXXXXXXXXXXXXXX XXXXXXXX  X XXXX XXXXXXX XXXXXXXXXXXX XXXXXXXXXXX      XXXX                XXXXX XXX XXXXX
XXXXXXXXXXXXXXXX                      XXXXXXXXXXXXX XXXXXXXX XX XXXX XXXXXXX XXXXXXXXXXXX XXXXXXXXXXXXXXXXXXXXXXXXXXXXXXXXXXXX XXXXX XXX XXXXX
XXXXXXXXXXXXXXXX XXXXXXXXXXXXXXXXXXXXXXXXXXXXXXXXXX XXXXXXXX XX XXXX XXXXXXX XXXXXXXXXXXX XXXXXXXXXXXXXXXXXXXXXXXXXXXXXXXXXXXX XXXXX XXX XXXXX
XXXXXXXXXXXXXXXX                            XXXXXXX XXXXXXXX  X XXXX XXXXXXX XXXXX                        XXXX XXXXXXXXXXXXXXX XXXXX XXX XXXXX
XXXXXXXXXXXXXXXX XXXXXXXX XXXXXXXXXXXXXXXXXXXXXXXXX XXXXXXXX XX XXXX         XXXXXXXXXXXXXXXXXXXXXXXXXXXX XXXX XXXXXXXXXXXXXXX XXX   XXX XXXXX
XXXXXXXXXXXXXXXX XXXXXXXX XXXXXXXXXXXXXXXXXXXXXXXXX XXXXXXXX XX XXXX XXXXXXX XXXXXXXXXXXXXXXXXXXXXXXXXXXX XXXX XXXXXXXXXXXXXXX XXX XXXXX XXXXX
XXXXXXXXXXXXXXXX XXXXXXXX XXXXXXXXXXXXXXXXXXXXXXXXX XXXXXXXX XX XXXX XXXXXXX XXXXXXXXXXXXXXXXXXXXXXXXXXXX XXXX XXXXXXXXXXXXXXX XXX XXXXX XXXXX
XXXX XXXXXXXXXXX XXXXXXXX                               XXXX  X XXXXXXXXXXXX XXXXXXXX              XXXXXX XXXX XXXXXXXXXXXXXXX XXX XXXXX XXXXX
XXXX XXXXXXXXXXX XXXXXXXX XXXXXXXXXXXXXXXXXXXXXXXXXXXXXXXXXX XX XXXXXXXXXXXX XXXXXXXX XXXXXXX XXXXXXXXXXX XXXX XXXXXXXXXXXXXXX XXX XXXXX XXXXX
XXXX XXXXXXXXXXX XXXXXXXX XXXXXXXXXXXXXXXXXXXXXXXXXXXXXXXXXX XX XXXXXXXXXXXX XXXXXXXX XXXXXXX XXXXXXXXXXX XXXX XXXXXXXXXXXXXXX XXX XXXXX XXXXX
XXXX XXXXXXXXXXX XXXXXXXX XXXXXXXXXXXXXXXXXXXXXXXXXXXXXXXXXX XX XXXXX XXXXXX XXXXXXXX XXXXXXX XXXXXXXXXXX XXXX XXXXXXXXXXXXXXX XXX XXXXX XXXXX
XXXX              XXXXXXXXXXXXXXXXXXXXXXXXXXX                XX XXXXX        XXXXXXXX XXXXXXX XXXXXXXXXXX XXXX XXXXXXXXXXXXXXX XXX XXXXX XXXXX
XXXX XXXXXXXXXXXXXXXXXXXXXXXXXXXXXXXXXXXXXXXX XXXXXXXXXXXXXXXXX XXXXX XXXXXX XXXXXXXX XXXXXXX XXXXXXXXXXX XXXX XXXXXXXXXXXXXXX XXX XXXXX XXXXX
XXXX XXXXXXXXXXXXXXXXXXXXXXXXXXXXXXXXXXXXXXXX XXXXXXXXXXXXXX XX XXXXX XXXXXX             XXXX XXXXXXXXXXX XXXX XXXXXXXXXXXXXXX XXX XXXXX XXXXX
XXXX XXXXXXXXXXXXXXXXXXXXXXXXXXXXXXXXXXXXXXXX XXXXXXXXXXXXXX XX XXXXX XXXXXX XXXXXXXXXXXXXXXX XXXXXXXXXXX XXXX XXXXXXXXXXXXXXX XXX XXXXX XXXXX
XXXX                                                          X XXXXX XXXXXX XXXXXXXXXXXXXXXX XXXXXXXXXXX XXXX XXXXXXXXXXXXXXX XXX XXXXX XXXXX
XXXX XXXXXXXXX XXXXXXXXXXXXXXXXXXXXXXXXXXXXXX XXXXXXXXXXXXXXXXX XXXXX XX     XXXXXXXXXXXXXXXX XXXXXXXXXXX XXXX XXXXXXXXXXXXXXX XXX XXXXX XXXXX
XXXX XXXXXXXXX XXXXXXXXXXXXXXXXXXXXXXXXXXXXXX XXXXXXXXXXXXXXXXX XXXXXXXX XXXXXXXXXXXXXXXXXXXX XXXXXXXXXXX XXXX XXXXXXXXXXXXXXX XXX XXXXX XXXXX
XXXX XXXXXXXXX XXXXXXXXXXXXXXXXXXXXXXXXXXXXXX XXXXXXXXXXXXXXXXX XXXXXXXX XXX XXXXXXXXXXXXXXXX XXXXXXXX XX XXXX XXXXXXXXXXXXXXX XXX XXXXX XXXXX
XXXX XXXXXXXXX XXXXXXXXXXXX                   XXXXXXXXXXXXXXXXX XXXXXXXX XX          XX          XXXXX XX XXXX XXXXXXXXXXXXXXX           XXXXX
XXXX XXXXXXXXX XXXXXXXXXXXX XXXXXXXXXXXXXXXXXXXXXXXXXXXXXXXXXXX XXXXXXXX XX XXXXXXX XXX XXXXX XXXXXXXX XX XXXX XXXXXXXXXXXXXXXXXXXXXXXXXXXXXXX
XXXX XXXXXXXXX XXXXXXXXXXXX XXXXXXXXXXXXX XXXXXXXXXXXXXXXXXXXXX XXXXXXXX XX XXXXXXX XXX XXXXX XXXXXXXX          XXXXXXXXXXXXXXXXXXXXXXXXXXXXXX
XXXX XXXXXXXXX XXXXXXXXXXXX XXXXXXXXXXXXX XXXXXXXXXXXXXXXXXXXXX XXXXXXXX XX XXXXXXX XXX XXXXX XXXXXXXX XXXXXXXXXXXXXXXXXXXXXXXXXXXXXXXXXXXXXXX
XXXX XXXXXXXXX XXXXXXXXXXXX             X XXXXXXXXXXXXXXXXXXXXX XXXXXXXX XX XXXXXXX XXX XXXXX XXXXXXXX XXXXXXXXXXXXXXXXXXXXXXXXXXXXXXXXXXXXXXX
XXXX XXXXXXXXX XXXXXXXXXXXX XXXXXXXXXXXXX XXXXXXXX                              XXX XXX XXXXX XXXXXXXX XXXXXXXXXXXXXXXXXXXXXXXXXXXXXXXXXXXXXXX
XXXX XXXXXXXXX XXXXXXXXXXXX XXXXXXXXXXXXX XXXXXXXXXXXXXXXXXXXXX XXXXXXXXXXXXXXXXXXX XXX XXXXX XXXXXXXX XXXXXXXXXXXXXXXXXXXXXXXXXXXXXXXXXXXXXXX
                            XXXXXXXXXXXXX XXXXXXXXXXXXXXXXXXXXX XXXXXXXXXXXXXXXXXXX XXX XXXXX XXXXXXXX XXXXXXXXXXXXXXXXXXXXXXXXXXXXXXXXXXXXXXX
 XXXXXXXXXXXXXXXXXXXXXXXXXXXXXXXXXXXXXXXX XXXXXXXXXXXXXXXXXXXXX XXXXXXXXXXXXXXXXXXX XXX XXXXX                  XXXXXXXXXXXXXXXXXXXXXXXXXXXXXXX
 XXXXXXXXXXXXXXXXXXXXXXXXXXXXXXXXXXXXXXXX XXXXXXXXXXXXXXXXXXXXXXXXXXXXXXXXXXXXXXXXX XXX XXXXXXXXXXXXXXXXXXXXXXXXXXXXXXXXXXXXXXXXXXXXXXXXXXXXXX
S                                          XXXXXXXXXXXXXXXXXXXXXXXXXXXXXXXXXXXXXXXX             XXXXXXXXXXXXXXXXXXXXXXXXXXXXXXXXXXXXXXXXXXXXXX