XXXXXX                                         XX                                  G
XXXXXX XXXXXXXXXXXXXXXXXXXXXXXXXXXXXXXXXXXXXXX XX XXXXXXXXXXXXXXXXXXXXXXXXXXXXXXXXXX
XXXXXX                                     XXX    XXXXXXXXXX XXXX XXXXXXXXXXXXX XX X
XXXXXXXXXXXXXXXXXXXXXXXXXXXXXXXXXXXXXXXXXX XXXXXXXXXXXXXXXXX XXXX XXXXXXXXXXXXX XX X
XXXXXX                                     XXXXXX                                  X
XXXXXX XXXXXXXXXXXXXXXXXXXXXXXXXXXXXXXXXX XXXXXXX XXXXXXXXXXXXXXXXXXXXXXXXXXXXXXXX X
XXXXXX XXXXXXXXXXXXXXXXXXXXXXXXXXXXXXXXXX XXXXXXX XXXXXXXXXXXXXXXXXXXXXXXXXXXXXXXX X
XXXXXX                          XXXXXXXXX XXXXXXX XXXXXXXXXXXXXXXXXXXXXXXXXXXXXXXX X
XXXXXXXXXXXXXXXXXXXXXXXXXXXXXXX XXXXXXXXX XXXXXXX XXXXXXXXXXXXXXXXXXXXXXXXXXXXXXXX X
XXXXXXXXXXXXXXXXXXXXXXXXXXXXXXX XXXXXXXXX XXXXXXX                                   
XXXXXXXXXXXXXXXXXXXXXXXXXXXXXXX XXXXXXXXX XXXXXXX XXXXXXX XXXXXXXXXXXX XXXXXXXXXXXXX
XXXXXXXXXXX XXXXXXXXXXXXXXXXXXX XXXXXXXXXXXXXXXXX XXXXXXX XXXXXXXXXXXX XXXXXXXXXXXXX
XXXXXXXXXXX XXXXXXXXXXXXXXXXXXX XXXXXXXXXXXXXXXXX XXXXXXX XXXXXXXXXXXX XXXXXXXXXXXXX
XXXXXXXXXXX XXXXXXXXXXX                            XXXXXX XXXXXXXXXXXX XXXXXXXXXXXXX
XXXXXXXXXXX       XXXXX XXXXXXXXXXXXXXXXXXXXXXXXXXXXXXXXX XXXXXXXXXXXX XXXXXXXXXXXXX
XXXXXXXXXXX XXXXXXXXXXX XXXXXXXXXXXXXXX XXXXXXXXXXXXXXXXX XXXXX XXXXXXXXXXXXXXXXXXXX
XXXXXXXXXXX XXXXXXXXXXX XXXXXXXXXXXXXXX XXXXXXXXXXXXXXXXX XXXXX XXXXXXXXXXXXXXXXXXXX
XXXXXXXXXXX XXXXXXXXXXX XXXXXXXXXXXXXXX XXXXXXXX XXXXXXXX XXXXX                 XXXX
XX          XXXXXXXXXXX XXXXXXXXXXXXXXX XXXXXXXX XXXXXXXXXXXXXX XXXXXXXXX XXXXXXXXXX
XXXXXXXXXXX XXXXXXXXXXX XXXXXXXXXXXXXXX XXXXXXXX XXXXXXXXXXXXXX XXXXXXXXX XXXXXXXXXX
XXXXXXXXXXX XXXXXXXXXXX XXXXXXXXXXXXXXX XXXXXXXX                 XXXXXXXX XXXXXXXXXX
XXXXXXXXXXX               XXXXXXXXXXXXX XXXXXXXX XXXXXXXXXXXXXXX XXXXXXXX XXXXXXXXXX
XXXXXXXXXXX XXXXXXXXXXXXXXXXXXXXXXXXXXX XXXXXXXX XXXXXXXXXXXXXXX XXXXXXXX XXXXXXXXXX
XXXXXXXXXXX XXXXXXXXXXXXXXXXXXXXX XXXXX XXXXXXXX XXXXXXXXXXXXXXX XXXXXXXX XXXXXXXXXX
XXXXXXXXXXX XXXXXXXXXXXXXXXXXXXXX XXXXX XXXXXXXX XXXXXXXXXXXXXXX XXXXXXXX XXXXXXXXXX
XXXXXXXXXXX XXXXXXXXXXXXXXXXXXXXX XXXXX                        X XXXXXXXX XXXXXXXXXX
XXX XXXXXXX XXXXXXXXXXXXXXXXXXXXX XXXXX XXXXXXXXXXXXXXXXXXXXXXXX XXXXXXXX         XX
XXX XXXXXXX XXXXXXXXXXXX XXXXXXXX XXXXX XXXXXXXXXXXXXXXXXXXXXXXX XXXXXXXX XXXXXXXXXX
XXX XXXXXXX XXXXXXXXXXXX     XXXX XXXXX XXXXXXXXXXXX XXXXXXXXXXXXXXXXXXXX XXXXXXXXXX
XXX XXXXXXX XXXXXXXXXXXX XXXXXXXX XXXXX XXXXXXXXXXXX XXXXXXXXXXXXXXXXXXXX XXXXXXXXXX
XXX XXXXXXX XXXXXXXXXXXX XXXXXXXX XXXXX XXXXXXXXXXXX XXXXXXXXXXXX XXXXXXX XXXXXXXXXX
XXX XXXXXXX XXXXXXXXXXXX XXXXXXXX XXXXX XXXXXXXXXXXX XXXXXXXXXXXX XXXXXXX XXXXXXXXXX
XXX XXXXXXX XXXXXXXXXXXX XXXXXXXX XXXXX XXXXXXXXXXXX XXXXXXXXXXXX XXXXXXXXXXXXXXXXXX
XXX XXXXXXX XXXXXXXXXXXX XXXXXXXX XXXXX XXXXXXXXXXXX XXXXXXXXXXXX XXXXXXXXXXXXXXXXXX
XXX XXXXXXX XXXXXXXXXXXX XXXXXXXX XXXXX XXXXXXXXXXXX XXXXXXXXXXXX XXXXXXXXXXXXXXXXXX
XXX XXXXXXX XXXXXXXXXXXX XXXXXXXX XXXXX XXXXXXXXXXXX XXXXXXXXXXXX XXXXXXXXXXXXXXXXXX
XXXS                                                               XXXXXXXXXXXXXXXXX
